1111111111111111111
1000CVEV00000001111
1110111100001100001
100V0000V00VC000001
1CCCCCCCPCVCVCCCCC1
101V1010101V1010101
100V111111111000001
1111111111111111111