1111111111111111111
1VV0CEP000000001111
11101111V1001100001
100V00000000V000001
1CCCCCCCCCCCCCCCCC1
1010101010101010101
1000111111111V00001
1111111111111111111