1111111111111111111
1000CEP000000001111
1110111110001100001
10000001V1000000001
1CCCCCCC1CCCCCCCCC1
1010101010101010101
1000111111111000001
1111111111111111111