1111111111111111111
100ECVPV00000001111
111011V100001100001
1000000000000000001
1CCCCCCCCCCCCCCCCC1
1010101010101010101
1000111111111000001
1111111111111111111