1111111111111111111
1000CEP000000001111
1110111110001100001
100V0001V1000000001
1CCCCCCV10CCCCCCCC1
101V101010101010101
1000000000000000001
1111111111111111111