1111111111111111111
1000CEP000000001111
1110111100001100001
100V0000V0000000001
1CCCCCCCCCCCCCCCCC1
101V101010101010101
100V111111111000001
1111111111111111111