1111111111111111111
1000CEP0000000V1111
11101111V1001100001
100V000V00000000001
1CCCC0CCCCVCCCCVCC1
1010101010101010101
1000111111111V00001
1111111111111111111