111111111111111
100100000C00111
100C11111001111
10001P1E0000011
111111111111111