111111111111111111
100100000C00111111
100C01111100111111
1000P1E00000111111
111111111111111111