111111111111111111111111111111111111
100000000000000000000000000000000001
100000000000000000000000C00000000001
100000000000000000000000000000000001
100000001111000000000000000000000001
1000000000000000000000E0000000000001
100000000000000000000000000000000001
1P00000000000000000000C0000000000001
100000000000000000000000000000000001
100000000CC0000000000000000000000001
100000000000000000000000000000000001
100000000111000000000000000000000001
1000000000000000000000000C0000000001
100000000000000000000000000000000001
111111111111111111111111111111111111