1111111111111
1001000C000011
1000011C11001
1PC0011E00001
1111111111111