1111111111111
10010000P000C
1000011111001
1P00011E00000
11111111111111