1111111113111
10010040000C1
1070011111001
1P0011E000001
1111111111111